{
    "nextMapUp": "map2",
    "nextMapDown": "map2",
    "nextMapLeft": "map2",
    "nextMapRight": "map2",
    "layers": {
        "layerOne": [
            [" ", " ", " ", " ", " ", " ", " ", " ", " ", " ", " ", " ", " ", " ", " "],
            [" ", " ", " ", " ", " ", " ", " ", " ", "G", " ", " ", " ", " ", " ", " "],
            [" ", " ", "G", "G", " ", " ", " ", "G", " ", " ", " ", " ", " ", " ", " "],
            [" ", " ", "G", "G", " ", " ", " ", " ", " ", " ", " ", " ", " ", " ", " "],
            [" ", " ", " ", " ", " ", " ", " ", " ", " ", " ", " ", " ", " ", " ", "G"],
            [" ", " ", " ", " ", " ", " ", " ", " ", " ", " ", " ", "G", " ", " ", " "],
            [" ", " ", " ", " ", " ", " ", " ", " ", " ", " ", "G", "G", "G", " ", " "],
            [" ", " ", "G", " ", " ", " ", " ", " ", " ", " ", " ", "G", " ", " ", " "],
            [" ", "G", " ", " ", "G", " ", " ", " ", " ", " ", " ", " ", " ", " ", "G"],
            [" ", " ", " ", " ", " ", " ", " ", "G", " ", " ", " ", " ", " ", " ", " "]
        ],
        "layerTwo": [
            ["T", " ", " ", " ", " ", " ", " ", " ", " ", " ", " ", " ", " ", " ", "T"],
            [" ", " ", " ", " ", " ", " ", " ", " ", " ", " ", " ", " ", " ", " ", " "],
            [" ", "T", "T", "T", " ", "T", "T", " ", "T", "T", "T", " ", "T", "T", "T"],
            [" ", " ", "T", " ", " ", "T", " ", " ", "T", " ", " ", " ", " ", "T", " "],
            [" ", " ", "T", " ", " ", "T", "T", " ", "T", " ", " ", " ", " ", "T", " "],
            [" ", " ", "T", " ", " ", "T", " ", " ", "T", "T", "T", " ", " ", "T", " "],
            [" ", " ", "T", " ", " ", "T", " ", " ", " ", " ", "T", " ", " ", "T", " "],
            [" ", " ", "T", " ", " ", "T", "T", " ", "T", "T", "T", " ", " ", "T", " "],
            [" ", " ", " ", " ", " ", " ", " ", " ", " ", " ", " ", " ", " ", " ", " "],
            ["T", " ", " ", " ", " ", " ", " ", " ", " ", " ", " ", " ", " ", " ", "T"]
        ],
        "layerThree": [
            [" ", " ", " ", " ", " ", " ", " ", "P", " ", " ", " ", " ", " ", " ", " "],
            [" ", " ", " ", " ", " ", " ", " ", " ", " ", " ", " ", " ", " ", " ", " "],
            [" ", " ", " ", " ", " ", " ", " ", " ", " ", " ", " ", " ", " ", " ", " "],
            [" ", " ", " ", " ", " ", " ", " ", " ", " ", " ", " ", " ", " ", " ", " "],
            [" ", " ", " ", " ", " ", " ", " ", " ", " ", " ", " ", " ", " ", " ", " "],
            [" ", " ", " ", " ", " ", " ", " ", " ", " ", " ", " ", " ", " ", " ", " "],
            [" ", " ", " ", " ", " ", " ", " ", " ", " ", " ", " ", " ", " ", " ", " "],
            [" ", " ", " ", " ", " ", " ", " ", " ", " ", " ", " ", " ", " ", " ", " "],
            [" ", " ", " ", " ", " ", " ", " ", " ", " ", " ", " ", " ", " ", " ", " "],
            [" ", " ", " ", " ", " ", " ", " ", " ", " ", " ", " ", " ", " ", " ", " "]
        ]
    }
}