{
    "nextMapUp": "map1",
    "nextMapDown": "map1",
    "nextMapLeft": "map1",
    "nextMapRight": "map1",
    "layers": {
        "layerOne": [
            [" ", " ", " ", " ", " ", " ", " ", " ", " ", " ", " ", " ", " ", " ", "G"],
            [" ", " ", " ", " ", " ", " ", " ", " ", " ", " ", " ", " ", " ", "G", "G"],
            [" ", " ", " ", " ", " ", " ", " ", " ", " ", " ", " ", " ", " ", " ", "G"],
            [" ", " ", " ", " ", " ", "G", " ", " ", " ", " ", " ", " ", " ", " ", " "],
            [" ", " ", " ", " ", "G", "G", "G", " ", " ", " ", " ", " ", " ", " ", " "],
            [" ", " ", " ", " ", " ", "G", " ", " ", " ", " ", " ", " ", " ", " ", " "],
            [" ", "G", " ", " ", " ", " ", " ", " ", " ", " ", " ", "G", " ", " ", " "],
            ["G", "G", "G", " ", " ", " ", " ", " ", " ", " ", "G", "G", "G", " ", " "],
            [" ", "G", " ", " ", " ", " ", " ", " ", " ", " ", " ", "G", " ", " ", " "],
            [" ", " ", " ", " ", " ", " ", " ", " ", " ", " ", " ", " ", " ", " ", " "]
        ],
        "layerTwo": [
            [" ", " ", " ", " ", " ", " ", " ", " ", " ", " ", " ", " ", " ", " ", " "],
            [" ", " ", " ", " ", " ", " ", " ", " ", " ", " ", " ", " ", " ", " ", "T"],
            [" ", " ", " ", " ", " ", " ", " ", " ", " ", " ", " ", " ", " ", " ", " "],
            [" ", " ", " ", " ", " ", "T", " ", " ", " ", " ", " ", " ", " ", " ", " "],
            [" ", " ", " ", " ", " ", " ", " ", " ", " ", " ", " ", " ", " ", " ", " "],
            [" ", " ", " ", " ", " ", " ", " ", " ", " ", " ", " ", " ", " ", " ", " "],
            [" ", " ", " ", " ", " ", " ", " ", " ", " ", " ", " ", " ", " ", " ", " "],
            [" ", "T", " ", " ", " ", " ", " ", " ", " ", " ", " ", "T", " ", " ", " "],
            [" ", " ", " ", " ", " ", " ", " ", " ", " ", " ", " ", " ", " ", " ", " "],
            [" ", " ", " ", " ", " ", " ", " ", " ", " ", " ", " ", " ", " ", " ", " "]
        ],
        "layerThree": [
            [" ", " ", " ", " ", " ", " ", " ", " ", " ", " ", " ", " ", " ", " ", " "],
            [" ", " ", " ", " ", " ", " ", " ", " ", " ", " ", " ", " ", " ", " ", " "],
            [" ", " ", " ", " ", " ", " ", " ", " ", " ", " ", " ", " ", " ", " ", " "],
            [" ", " ", " ", " ", " ", " ", " ", " ", " ", " ", " ", " ", " ", " ", " "],
            ["P", " ", " ", " ", " ", " ", " ", " ", " ", " ", " ", " ", " ", " ", " "],
            [" ", " ", " ", " ", " ", " ", " ", " ", " ", " ", " ", " ", " ", " ", " "],
            [" ", " ", " ", " ", " ", " ", " ", " ", " ", " ", " ", " ", " ", " ", " "],
            [" ", " ", " ", " ", " ", " ", " ", " ", " ", " ", " ", " ", " ", " ", " "],
            [" ", " ", " ", " ", " ", " ", " ", " ", " ", " ", " ", " ", " ", " ", " "],
            [" ", " ", " ", " ", " ", " ", " ", " ", " ", " ", " ", " ", " ", " ", " "]
        ]
    }
}