{
    "backgroundColor": "#70c8a0",
    "nextMapUp": "",
    "nextMapDown": "grassCity/map2",
    "nextMapLeft": "",
    "nextMapRight": "",
    "layers": {
        "layerOne": [
            [" ", " ", " ", " ", " ", " ", " ", " ", " ", " ", " ", " ", " ", " ", " "],
            [" ", " ", " ", " ", " ", " ", " ", " ", "G", " ", " ", " ", " ", " ", " "],
            [" ", " ", "G", "G", " ", " ", " ", "G", " ", " ", " ", " ", " ", " ", " "],
            [" ", " ", "G", "G", " ", " ", " ", " ", " ", " ", " ", " ", " ", " ", " "],
            [" ", " ", " ", " ", " ", " ", " ", " ", " ", " ", " ", " ", " ", " ", "G"],
            [" ", " ", " ", " ", " ", " ", " ", " ", " ", " ", " ", "G", " ", " ", " "],
            [" ", " ", " ", " ", " ", " ", " ", " ", " ", " ", "G", "G", "G", " ", " "],
            [" ", " ", "G", " ", " ", " ", " ", " ", " ", " ", " ", "G", " ", " ", " "],
            [" ", "G", " ", " ", "G", " ", " ", " ", " ", " ", " ", " ", " ", " ", "G"],
            [" ", " ", " ", " ", " ", " ", " ", "G", " ", " ", " ", " ", " ", " ", " "]
        ],
        "layerTwo": [
            ["T", "T", "T", "T", "T", "T", "T", "T", "T", "T", "T", "T", "T", "T", "T"],
            ["T", " ", " ", " ", " ", " ", " ", " ", " ", " ", " ", " ", " ", " ", "T"],
            ["T", " ", "T", " ", " ", " ", " ", " ", " ", " ", " ", "T", " ", " ", "T"],
            ["T", " ", " ", " ", " ", " ", " ", " ", " ", " ", " ", " ", " ", " ", "T"],
            ["T", " ", " ", " ", " ", " ", " ", " ", " ", " ", " ", " ", " ", " ", "T"],
            ["T", " ", " ", "T", " ", " ", " ", " ", " ", " ", " ", " ", " ", " ", "T"],
            ["T", " ", " ", " ", " ", " ", " ", " ", " ", " ", " ", " ", " ", " ", "T"],
            ["T", " ", " ", " ", " ", " ", " ", " ", " ", " ", " ", " ", " ", " ", "T"],
            ["T", " ", " ", " ", " ", " ", " ", " ", " ", " ", " ", " ", " ", " ", "T"],
            ["T", " ", " ", " ", " ", " ", " ", " ", " ", " ", " ", " ", " ", "T", "T"]
        ],
        "layerThree": [
            [" ", " ", " ", " ", " ", " ", " ", " ", " ", " ", " ", " ", " ", " ", " "],
            [" ", " ", " ", " ", " ", " ", " ", "P", " ", " ", " ", " ", " ", " ", " "],
            [" ", " ", " ", " ", " ", " ", " ", " ", " ", " ", " ", " ", " ", " ", " "],
            [" ", " ", " ", " ", " ", " ", " ", " ", " ", " ", " ", " ", " ", " ", " "],
            [" ", " ", " ", " ", " ", " ", " ", " ", " ", " ", " ", " ", " ", " ", " "],
            [" ", " ", " ", " ", " ", " ", " ", " ", " ", " ", " ", " ", " ", " ", " "],
            [" ", " ", " ", " ", " ", " ", " ", " ", " ", " ", " ", " ", " ", " ", " "],
            [" ", " ", " ", " ", " ", " ", " ", " ", " ", " ", " ", " ", " ", " ", " "],
            [" ", " ", " ", " ", " ", " ", " ", " ", " ", " ", " ", " ", " ", " ", " "],
            [" ", " ", " ", " ", " ", " ", " ", " ", " ", " ", " ", " ", " ", " ", " "]
        ]
    }
}