{
    "backgroundColor": "#70c8a0",
    "nextMapUp": "grassCity/map1",
    "nextMapDown": "",
    "nextMapLeft": "",
    "nextMapRight": "grassCity/map3",
    "layers": {
        "layerOne": [
            [" ", " ", " ", " ", " ", " ", " ", " ", " ", " ", " ", " ", " ", " ", "G"],
            [" ", " ", " ", " ", " ", " ", " ", " ", " ", " ", " ", " ", " ", "G", "G"],
            [" ", " ", " ", " ", " ", " ", " ", " ", " ", " ", " ", " ", " ", " ", "G"],
            [" ", " ", " ", " ", " ", "G", " ", " ", " ", " ", " ", " ", " ", " ", " "],
            [" ", " ", " ", " ", "G", "G", "G", " ", " ", " ", " ", " ", " ", " ", " "],
            [" ", " ", " ", " ", " ", "G", " ", " ", " ", " ", " ", " ", " ", " ", " "],
            [" ", "G", " ", " ", " ", " ", " ", " ", " ", " ", " ", "G", " ", " ", " "],
            ["G", "G", "G", " ", " ", " ", " ", " ", " ", " ", "G", "G", "G", " ", " "],
            [" ", "G", " ", " ", " ", " ", " ", " ", " ", " ", " ", "G", " ", " ", " "],
            [" ", " ", " ", " ", " ", " ", " ", " ", " ", " ", " ", " ", " ", " ", " "]
        ],
        "layerTwo": [
            ["T", " ", " ", " ", " ", " ", " ", " ", " ", " ", " ", " ", " ", " ", " "],
            ["T", " ", " ", " ", " ", " ", " ", " ", " ", " ", " ", " ", " ", " ", "T"],
            ["T", " ", " ", " ", " ", " ", " ", " ", " ", " ", " ", " ", " ", " ", " "],
            ["T", " ", " ", " ", " ", "T", " ", " ", " ", " ", " ", " ", " ", " ", " "],
            ["T", " ", " ", " ", " ", " ", " ", " ", " ", " ", " ", " ", " ", " ", " "],
            ["T", " ", " ", " ", " ", " ", " ", " ", " ", " ", " ", " ", " ", " ", " "],
            ["T", " ", " ", " ", " ", " ", " ", " ", " ", " ", " ", " ", " ", " ", " "],
            ["T", "T", " ", " ", " ", " ", " ", " ", " ", " ", " ", "T", " ", " ", " "],
            ["T", " ", " ", " ", " ", " ", " ", " ", " ", " ", " ", " ", " ", " ", " "],
            ["T", "T", "T", "T", "T", "T", "T", "T", "T", "T", "T", "T", "T", "T", "T"]
        ],
        "layerThree": [
            ["P", " ", " ", " ", " ", " ", " ", " ", " ", " ", " ", " ", " ", " ", " "],
            [" ", " ", " ", " ", " ", " ", " ", " ", " ", " ", " ", " ", " ", " ", " "],
            [" ", " ", " ", " ", " ", " ", " ", " ", " ", " ", " ", " ", " ", " ", " "],
            [" ", " ", " ", " ", " ", " ", " ", " ", " ", " ", " ", " ", " ", " ", " "],
            [" ", " ", " ", " ", " ", " ", " ", " ", " ", " ", " ", " ", " ", " ", " "],
            [" ", " ", " ", " ", " ", " ", " ", " ", " ", " ", " ", " ", " ", " ", " "],
            [" ", " ", " ", " ", " ", " ", " ", " ", " ", " ", " ", " ", " ", " ", " "],
            [" ", " ", " ", " ", " ", " ", " ", " ", " ", " ", " ", " ", " ", " ", " "],
            [" ", " ", " ", " ", " ", " ", " ", " ", " ", " ", " ", " ", " ", " ", " "],
            [" ", " ", " ", " ", " ", " ", " ", " ", " ", " ", " ", " ", " ", " ", " "]
        ]
    }
}