{
    "backgroundColor": "#70c8a0",
    "nextMapUp": "",
    "nextMapDown": "",
    "nextMapLeft": "grassCity/map2",
    "nextMapRight": "",
    "layers": {
        "layerOne": [
            [" ", " ", " ", " ", " ", " ", "G", " ", " ", " ", " ", " ", " ", " ", "G"],
            [" ", " ", " ", " ", " ", " ", " ", " ", " ", " ", " ", " ", " ", " ", " "],
            [" ", " ", "G", " ", " ", " ", " ", " ", " ", "G", " ", " ", " ", " ", " "],
            [" ", " ", " ", " ", " ", " ", " ", " ", " ", " ", " ", " ", " ", " ", " "],
            ["G", " ", " ", " ", " ", " ", " ", " ", " ", " ", " ", " ", " ", " ", " "],
            [" ", " ", " ", " ", " ", " ", " ", " ", " ", " ", " ", " ", "G", " ", " "],
            [" ", " ", " ", " ", " ", "G", " ", " ", " ", " ", " ", " ", " ", " ", " "],
            [" ", " ", " ", " ", " ", " ", " ", " ", " ", " ", " ", " ", " ", " ", " "],
            [" ", " ", " ", "G", " ", " ", " ", " ", " ", " ", " ", " ", " ", " ", " "],
            [" ", " ", " ", " ", " ", " ", " ", " ", " ", " ", "G", " ", " ", " ", " "]
        ],
        "layerTwo": [
            ["T", "T", "T", "T", "T", "T", "T", "T", "T", "T", "T", "T", "T", "T", "T"],
            [" ", " ", " ", " ", " ", " ", " ", " ", " ", " ", " ", " ", " ", " ", "T"],
            [" ", " ", " ", " ", " ", " ", " ", " ", " ", " ", " ", " ", " ", " ", "T"],
            [" ", " ", " ", " ", " ", " ", " ", " ", " ", " ", " ", " ", " ", " ", "T"],
            [" ", " ", " ", " ", " ", " ", " ", " ", " ", " ", " ", " ", " ", " ", "T"],
            [" ", " ", " ", " ", " ", " ", " ", " ", " ", " ", " ", " ", " ", " ", "T"],
            [" ", " ", " ", " ", " ", " ", " ", " ", " ", " ", " ", " ", " ", " ", "T"],
            [" ", " ", " ", " ", " ", " ", " ", " ", " ", " ", " ", " ", " ", " ", "T"],
            [" ", " ", " ", " ", " ", " ", " ", " ", " ", " ", " ", " ", " ", " ", "T"],
            ["T", "T", "T", "T", "T", "T", "T", "T", "T", "T", "T", "T", "T", "T", "T"]
        ],
        "layerThree": [
            ["P", " ", " ", " ", " ", " ", " ", " ", " ", " ", " ", " ", " ", " ", " "],
            [" ", " ", " ", " ", " ", " ", " ", " ", " ", " ", " ", " ", " ", " ", " "],
            [" ", " ", " ", " ", " ", " ", " ", " ", " ", " ", " ", " ", " ", " ", " "],
            [" ", " ", " ", " ", " ", " ", " ", " ", " ", " ", " ", " ", " ", " ", " "],
            [" ", " ", " ", " ", " ", " ", " ", " ", " ", " ", " ", " ", " ", " ", " "],
            [" ", " ", " ", " ", " ", " ", " ", " ", " ", " ", " ", " ", " ", " ", " "],
            [" ", " ", " ", " ", " ", " ", " ", " ", " ", " ", " ", " ", " ", " ", " "],
            [" ", " ", " ", " ", " ", " ", " ", " ", " ", " ", " ", " ", " ", " ", " "],
            [" ", " ", " ", " ", " ", " ", " ", " ", " ", " ", " ", " ", " ", " ", " "],
            [" ", " ", " ", " ", " ", " ", " ", " ", " ", " ", " ", " ", " ", " ", " "]
        ]
    }
}